#########################
#.......................#
#.#.#.#.#.#.#.#.#.#.#.#.#
#...........o...........#
#.#.#.#.#.#.#.#.#.#.#.#.#
#.......................#
#.#.#.#.#.#.#.#.#.#.#.#.#
#......o.........o......#
#.#.#.#.#.#.#.#.#.#.#.#.#
#.......................#
#.#.#.#.#.#.#.#.#.#.#.#.#
#...........o...........#
#.#.#.#.#.#.#.#.#.#.#.#.#
#.......................#
#########################